NO ./north.xpm
SO ./south.xpm
WE ./west.xpm
EA ./east.xpm


F 255,255,255
C 0,00,00

1111                
1S11
1011
1011
101 1
1011
1011
101
1011
1011
111
111
