
SO ./south.xpm
EA ./east.xpm
NO ./north.xpm
WE ./west.xpm

F 20, 50, 02
C 10, 120, 30

11111111111
11000001111
11000111101
11000011101
1100N000001
11000000001
11010010111
11010010011
11000111111
11111111111
