SO ./south.xpm
NO ./north.xpm
EA ./east.xpm
WE ./west.xpm

F 212, 26, 26
C 10, 10, 204

1111111111 1111
111000000111001
110000000111001111
1000N0000000000001
110000000111111101
1110000001     101
1111111111     111
